0, 4, 4, 4, 4, 4, 4, 4, 5, 5, 10, 10, 3, 4, 8, 8, 10, 10, 9, 4, 10, 4, 4, 4, 5, 2, 7, 8, 6, 8, 8, 8, 2, 8, 8, 7, 5, 2, 2, 5, 5, 2, 5, 2, 10, 8, 10, 5, 10, 10, 10, 5, 5, 5, 5, 5, 5, 2, 2, 2, 2, 7, 7, 3, 7, 7, 2, 3, 7, 7, 7, 7, 0, 3, 3, 6, 6, 3, 6, 6, 3, 6, 6, 3, 3, 3, 2, 7, 0, 3, 0, 3, 0, 1, 7, 3, 10, 3, 3, 2, 5, 2, 5, 2, 5, 5, 2, 2, 2, 2, 1, 3, 8, 2, 2, 2, 10, 10, 0, 8, 8, 8, 0, 6, 5, 5, 8, 9, 6, 6, 6, 0, 0, 3, 9, 9, 9, 6, 10, 6, 8, 10, 8, 10, 3, 3, 10, 5, 2, 3, 8, 8, 4, 8, 10, 1, 4, 4, 4, 4, 10, 7, 3, 9, 1, 0, 1, 2, 5, 10, 3, 6, 0, 5, 4, 5, 6, 3, 2, 7, 7
1, 4, 4, 6, 4, 4, 4, 4, 6, 6, 1, 7, 7, 4, 0, 0, 4, 4, 4, 4, 4, 4, 4, 4, 6, 2, 3, 0, 6, 0, 0, 0, 2, 0, 0, 0, 6, 2, 2, 6, 6, 2, 1, 2, 1, 1, 1, 6, 4, 4, 1, 6, 6, 6, 6, 6, 6, 2, 2, 2, 2, 8, 8, 7, 8, 8, 3, 0, 0, 8, 8, 0, 1, 7, 7, 3, 3, 7, 3, 3, 7, 3, 3, 7, 1, 7, 1, 0, 8, 7, 1, 7, 1, 1, 8, 7, 1, 0, 0, 2, 6, 2, 6, 2, 6, 6, 2, 2, 2, 2, 9, 7, 9, 2, 2, 2, 6, 1, 9, 9, 5, 9, 5, 3, 6, 6, 9, 5, 3, 3, 3, 5, 5, 5, 5, 5, 1, 3, 5, 3, 4, 4, 4, 4, 7, 7, 4, 6, 2, 7, 0, 0, 4, 9, 4, 1, 4, 4, 4, 4, 4, 0, 0, 5, 5, 8, 9, 2, 6, 7, 7, 3, 9, 6, 2, 6, 3, 0, 9, 8, 8
2, 1, 1, 7, 1, 1, 1, 1, 7, 7, 0, 10, 3, 1, 13, 13, 1, 10, 1, 1, 1, 1, 1, 1, 7, 6, 0, 9, 7, 9, 13, 13, 9, 13, 13, 13, 7, 6, 6, 4, 7, 6, 7, 6, 9, 10, 10, 7, 10, 10, 10, 7, 7, 7, 7, 7, 7, 9, 6, 6, 6, 5, 5, 3, 5, 5, 2, 9, 9, 5, 5, 9, 12, 3, 9, 0, 0, 3, 0, 0, 3, 0, 0, 3, 9, 3, 9, 9, 12, 5, 12, 12, 12, 12, 2, 3, 10, 9, 9, 6, 7, 6, 7, 6, 7, 7, 6, 4, 6, 6, 2, 8, 8, 6, 6, 6, 10, 10, 11, 8, 8, 8, 11, 0, 7, 7, 13, 8, 0, 0, 9, 11, 11, 3, 3, 11, 2, 0, 10, 0, 7, 10, 13, 10, 3, 3, 4, 7, 6, 9, 9, 13, 7, 8, 1, 2, 1, 1, 1, 10, 1, 13, 9, 1, 12, 12, 2, 6, 4, 8, 9, 0, 11, 4, 7, 7, 11, 9, 2, 5, 5
3, 2, 4, 4, 2, 4, 4, 4, 8, 8, 7, 11, 7, 4, 1, 1, 4, 11, 12, 4, 4, 4, 4, 4, 13, 6, 0, 5, 8, 5, 5, 2, 10, 14, 1, 5, 8, 6, 10, 8, 8, 6, 8, 6, 10, 11, 11, 8, 4, 11, 11, 8, 8, 8, 8, 6, 6, 10, 10, 10, 6, 13, 13, 7, 13, 14, 14, 7, 5, 14, 14, 13, 3, 7, 7, 0, 0, 9, 0, 0, 1, 0, 0, 7, 10, 1, 12, 9, 14, 7, 3, 10, 14, 12, 0, 1, 11, 7, 1, 6, 8, 6, 8, 6, 8, 6, 6, 10, 6, 6, 12, 7, 13, 6, 6, 6, 11, 11, 3, 2, 3, 2, 3, 0, 8, 8, 2, 2, 0, 0, 0, 3, 14, 9, 1, 9, 12, 9, 11, 0, 4, 11, 2, 11, 7, 1, 11, 8, 6, 7, 5, 5, 4, 2, 4, 2, 4, 4, 4, 4, 2, 5, 1, 4, 3, 14, 12, 6, 13, 7, 7, 0, 3, 8, 8, 8, 0, 9, 12, 13, 13
4, 0, 4, 0, 0, 0, 0, 0, 9, 9, 11, 11, 7, 0, 12, 12, 11, 11, 4, 0, 4, 4, 4, 4, 9, 5, 14, 6, 9, 6, 12, 12, 12, 12, 12, 12, 9, 9, 5, 9, 9, 9, 9, 5, 11, 11, 11, 9, 11, 11, 11, 9, 9, 9, 9, 9, 9, 5, 5, 5, 5, 14, 1, 7, 14, 12, 2, 1, 12, 1, 1, 14, 2, 7, 7, 1, 1, 15, 1, 3, 2, 1, 1, 7, 15, 7, 6, 15, 10, 15, 15, 15, 2, 10, 15, 7, 11, 1, 15, 5, 9, 9, 9, 5, 9, 9, 5, 5, 5, 5, 6, 7, 14, 5, 5, 5, 11, 11, 8, 13, 8, 0, 8, 10, 9, 9, 13, 13, 10, 1, 1, 8, 8, 6, 8, 8, 15, 6, 4, 9, 4, 4, 11, 11, 7, 7, 11, 9, 5, 7, 6, 12, 0, 13, 13, 13, 4, 4, 4, 4, 13, 12, 12, 13, 10, 10, 6, 5, 9, 7, 7, 1, 8, 9, 9, 9, 1, 1, 5, 14, 14
5, 1, 5, 5, 1, 1, 1, 1, 4, 4, 10, 12, 10, 1, 17, 17, 1, 12, 15, 1, 1, 1, 1, 1, 4, 13, 2, 16, 9, 16, 17, 20, 17, 17, 17, 17, 14, 14, 13, 14, 14, 18, 14, 13, 16, 14, 12, 14, 12, 12, 12, 4, 14, 4, 14, 14, 4, 18, 18, 13, 13, 11, 11, 10, 11, 11, 9, 10, 16, 6, 6, 2, 7, 10, 3, 2, 2, 3, 2, 2, 10, 2, 2, 10, 16, 3, 16, 16, 7, 18, 7, 7, 7, 6, 7, 10, 12, 16, 16, 13, 4, 4, 5, 13, 4, 4, 5, 18, 13, 13, 0, 11, 0, 13, 13, 13, 12, 12, 19, 20, 19, 20, 19, 9, 4, 4, 20, 15, 5, 2, 2, 7, 0, 8, 3, 15, 9, 10, 12, 2, 5, 12, 5, 12, 10, 10, 1, 5, 13, 3, 16, 16, 14, 5, 1, 20, 5, 5, 1, 1, 5, 17, 16, 15, 6, 6, 0, 13, 4, 11, 14, 13, 19, 4, 4, 4, 2, 3, 9, 11, 11
6, 10, 9, 12, 10, 10, 9, 9, 2, 2, 11, 8, 8, 9, 5, 5, 9, 9, 9, 9, 9, 9, 9, 9, 2, 1, 6, 3, 12, 8, 5, 5, 5, 5, 5, 5, 2, 1, 1, 2, 2, 1, 2, 1, 11, 3, 8, 2, 9, 9, 8, 2, 2, 2, 2, 2, 2, 1, 1, 1, 1, 5, 6, 6, 5, 5, 0, 6, 3, 0, 0, 3, 7, 8, 6, 0, 0, 6, 6, 11, 8, 0, 0, 8, 3, 8, 3, 3, 7, 3, 7, 7, 7, 7, 6, 6, 8, 8, 3, 1, 2, 2, 2, 1, 2, 2, 1, 1, 1, 1, 10, 6, 3, 1, 1, 1, 2, 8, 10, 10, 11, 10, 4, 0, 2, 12, 0, 11, 0, 0, 0, 4, 0, 4, 4, 12, 12, 0, 9, 12, 9, 9, 10, 9, 6, 8, 9, 2, 1, 6, 0, 5, 9, 10, 9, 10, 9, 9, 9, 9, 9, 5, 5, 9, 7, 7, 7, 1, 2, 6, 6, 0, 4, 2, 2, 2, 0, 6, 10, 5, 5
7, 3, 1, 6, 1, 1, 1, 1, 6, 6, 1, 5, 5, 1, 0, 0, 1, 1, 1, 1, 1, 1, 1, 1, 6, 6, 2, 0, 6, 0, 0, 4, 0, 0, 0, 0, 6, 3, 3, 6, 6, 3, 6, 3, 5, 6, 1, 6, 1, 6, 1, 6, 6, 6, 6, 6, 6, 3, 3, 3, 3, 4, 4, 5, 4, 4, 7, 8, 0, 4, 8, 2, 7, 5, 5, 8, 8, 5, 8, 5, 5, 8, 8, 5, 5, 5, 5, 0, 7, 0, 7, 7, 2, 2, 2, 5, 6, 0, 0, 3, 6, 6, 6, 3, 6, 6, 3, 3, 3, 3, 4, 5, 4, 3, 3, 3, 6, 1, 7, 4, 4, 4, 7, 8, 6, 6, 4, 8, 8, 8, 8, 8, 8, 8, 8, 3, 8, 8, 1, 6, 1, 1, 1, 1, 5, 5, 1, 6, 3, 5, 0, 0, 6, 4, 1, 4, 1, 1, 1, 1, 1, 0, 0, 8, 7, 7, 2, 3, 6, 5, 5, 5, 3, 6, 3, 6, 8, 8, 2, 0, 4
8, 3, 3, 8, 3, 3, 3, 3, 8, 8, 7, 7, 5, 3, 9, 9, 3, 7, 3, 3, 3, 3, 3, 3, 8, 10, 4, 9, 8, 9, 9, 9, 5, 1, 9, 9, 8, 10, 10, 1, 8, 10, 1, 10, 1, 7, 7, 1, 7, 7, 7, 8, 8, 8, 1, 1, 1, 10, 0, 10, 10, 0, 0, 5, 0, 0, 11, 5, 9, 0, 1, 4, 2, 5, 5, 4, 4, 5, 4, 7, 5, 4, 4, 5, 7, 5, 10, 9, 2, 5, 2, 5, 2, 2, 2, 5, 7, 9, 1, 10, 8, 8, 8, 10, 8, 8, 10, 8, 10, 10, 11, 0, 6, 10, 10, 10, 7, 7, 6, 11, 6, 11, 6, 4, 8, 8, 11, 11, 4, 4, 4, 6, 6, 5, 6, 6, 1, 4, 11, 4, 3, 7, 9, 7, 5, 5, 7, 1, 10, 5, 9, 9, 3, 11, 3, 11, 3, 3, 3, 3, 3, 9, 9, 11, 2, 2, 2, 10, 8, 0, 5, 4, 6, 8, 8, 8, 4, 5, 6, 0, 0
9, 13, 0, 0, 13, 13, 13, 13, 15, 15, 1, 2, 1, 0, 7, 7, 0, 13, 13, 13, 0, 0, 13, 0, 15, 4, 10, 12, 15, 12, 7, 7, 13, 7, 7, 7, 15, 11, 4, 11, 11, 11, 11, 4, 12, 12, 12, 15, 0, 12, 2, 15, 15, 15, 15, 11, 15, 13, 2, 4, 4, 10, 10, 1, 10, 7, 8, 11, 3, 10, 11, 10, 5, 1, 1, 8, 8, 2, 8, 8, 2, 8, 8, 1, 12, 1, 5, 5, 6, 3, 6, 3, 6, 6, 10, 1, 12, 5, 3, 4, 15, 15, 15, 4, 15, 15, 2, 4, 4, 4, 14, 1, 10, 4, 4, 4, 2, 2, 9, 9, 9, 12, 9, 8, 15, 15, 14, 5, 15, 8, 5, 9, 2, 2, 3, 9, 15, 8, 2, 8, 0, 0, 12, 12, 1, 1, 13, 15, 4, 1, 5, 5, 0, 0, 13, 14, 0, 0, 13, 0, 0, 7, 3, 2, 6, 6, 14, 4, 15, 1, 1, 8, 9, 15, 15, 15, 5, 5, 13, 3, 10
10, 8, 8, 8, 8, 8, 8, 8, 2, 2, 8, 0, 4, 8, 5, 1, 8, 0, 0, 8, 8, 0, 8, 8, 2, 6, 10, 1, 12, 5, 1, 5, 1, 1, 1, 1, 2, 2, 6, 2, 2, 6, 2, 6, 10, 0, 0, 0, 8, 0, 0, 2, 2, 2, 2, 2, 2, 6, 6, 6, 6, 7, 7, 4, 7, 7, 5, 4, 5, 12, 1, 1, 3, 4, 4, 12, 12, 4, 12, 12, 4, 12, 12, 4, 6, 4, 6, 1, 3, 1, 3, 3, 3, 3, 11, 4, 5, 5, 1, 2, 2, 2, 2, 6, 2, 2, 6, 6, 6, 6, 11, 4, 7, 6, 6, 9, 0, 0, 9, 5, 9, 5, 9, 12, 12, 12, 5, 9, 12, 12, 12, 9, 12, 12, 4, 3, 12, 12, 0, 12, 0, 0, 5, 0, 4, 4, 0, 0, 6, 4, 12, 5, 8, 0, 0, 5, 8, 0, 8, 8, 0, 1, 1, 9, 3, 3, 11, 6, 2, 4, 4, 6, 9, 0, 12, 12, 12, 1, 6, 7, 7
11, 5, 3, 3, 3, 3, 3, 3, 7, 7, 8, 9, 6, 3, 2, 2, 3, 3, 3, 3, 3, 3, 3, 3, 7, 7, 1, 3, 7, 9, 2, 2, 2, 2, 2, 2, 7, 7, 8, 7, 7, 8, 7, 8, 8, 3, 3, 7, 3, 3, 9, 7, 7, 7, 7, 7, 7, 8, 8, 8, 8, 2, 2, 6, 2, 2, 1, 6, 2, 2, 2, 9, 0, 6, 6, 1, 0, 6, 1, 1, 6, 1, 1, 6, 6, 6, 8, 2, 0, 6, 0, 6, 0, 0, 0, 6, 9, 1, 2, 8, 7, 7, 7, 8, 7, 7, 8, 7, 8, 8, 4, 8, 4, 8, 8, 8, 9, 9, 5, 4, 5, 3, 5, 1, 7, 7, 3, 3, 1, 1, 1, 5, 5, 6, 5, 5, 6, 1, 1, 1, 3, 9, 3, 3, 6, 6, 3, 7, 7, 6, 1, 9, 3, 3, 3, 3, 3, 3, 3, 3, 3, 2, 2, 3, 0, 0, 4, 8, 7, 8, 6, 6, 5, 7, 7, 7, 1, 2, 8, 2, 2
12, 3, 0, 0, 3, 3, 3, 3, 0, 0, 3, 3, 3, 3, 5, 5, 3, 3, 1, 3, 3, 3, 3, 3, 0, 0, 4, 1, 0, 5, 5, 5, 5, 5, 5, 5, 0, 6, 6, 0, 0, 6, 0, 6, 1, 0, 3, 0, 3, 3, 3, 0, 0, 0, 0, 0, 0, 6, 6, 6, 6, 5, 5, 4, 5, 5, 6, 1, 5, 4, 4, 4, 2, 1, 1, 4, 4, 1, 4, 1, 1, 4, 4, 1, 1, 1, 6, 5, 4, 1, 1, 1, 1, 4, 4, 1, 3, 1, 5, 6, 0, 0, 0, 6, 0, 0, 6, 0, 6, 6, 4, 1, 6, 6, 6, 6, 3, 3, 2, 5, 2, 1, 2, 0, 0, 0, 5, 1, 0, 0, 4, 2, 2, 1, 2, 2, 3, 1, 3, 0, 0, 3, 3, 3, 1, 1, 3, 0, 6, 1, 1, 5, 3, 1, 3, 1, 3, 0, 3, 3, 3, 5, 5, 3, 4, 4, 4, 6, 0, 1, 1, 4, 2, 0, 0, 0, 4, 1, 6, 5, 5
13, 7, 11, 7, 7, 7, 7, 7, 5, 5, 3, 3, 1, 7, 10, 10, 12, 3, 7, 12, 12, 7, 7, 11, 5, 5, 0, 3, 8, 4, 10, 10, 12, 10, 10, 10, 5, 2, 2, 5, 5, 2, 5, 2, 4, 3, 3, 5, 3, 12, 3, 5, 5, 5, 5, 5, 5, 2, 8, 2, 2, 13, 0, 1, 13, 13, 11, 0, 4, 0, 0, 0, 14, 1, 1, 0, 0, 11, 0, 8, 1, 8, 8, 1, 4, 1, 4, 4, 6, 4, 6, 4, 6, 6, 0, 1, 3, 4, 4, 2, 5, 5, 5, 2, 5, 5, 11, 11, 2, 2, 9, 1, 9, 2, 2, 2, 3, 3, 14, 14, 14, 7, 14, 8, 5, 8, 13, 13, 8, 8, 0, 14, 14, 11, 2, 8, 11, 8, 3, 8, 8, 3, 10, 3, 1, 1, 3, 5, 2, 4, 10, 10, 12, 7, 7, 13, 7, 7, 12, 12, 7, 10, 4, 7, 6, 6, 9, 9, 5, 1, 1, 8, 14, 5, 5, 5, 0, 4, 9, 13, 13
14, 4, 4, 0, 4, 4, 4, 4, 0, 0, 7, 6, 7, 4, 1, 1, 4, 4, 4, 4, 4, 4, 4, 4, 0, 3, 8, 2, 0, 1, 2, 1, 8, 1, 1, 2, 0, 3, 3, 0, 0, 3, 0, 3, 3, 6, 6, 0, 4, 6, 6, 0, 0, 0, 0, 0, 0, 3, 3, 3, 3, 8, 8, 7, 8, 8, 8, 2, 1, 8, 8, 2, 2, 7, 7, 7, 2, 7, 7, 7, 7, 7, 7, 7, 6, 7, 3, 2, 8, 1, 5, 5, 5, 8, 8, 6, 1, 1, 1, 3, 0, 3, 0, 3, 0, 0, 0, 0, 3, 3, 3, 7, 3, 3, 3, 3, 6, 6, 5, 1, 1, 1, 5, 7, 0, 0, 1, 4, 0, 0, 2, 5, 2, 6, 5, 5, 8, 7, 4, 0, 4, 6, 1, 6, 6, 6, 4, 0, 6, 2, 2, 1, 0, 4, 4, 1, 4, 4, 4, 4, 4, 2, 1, 4, 5, 8, 8, 3, 0, 3, 7, 7, 5, 0, 0, 0, 2, 1, 3, 8, 8
15, 7, 4, 4, 4, 4, 4, 4, 5, 5, 4, 3, 3, 4, 2, 2, 4, 4, 4, 4, 4, 4, 4, 4, 5, 7, 1, 1, 1, 2, 2, 2, 6, 6, 2, 2, 5, 7, 7, 5, 5, 7, 4, 7, 2, 4, 4, 5, 4, 4, 4, 5, 5, 5, 5, 5, 5, 7, 7, 7, 7, 6, 6, 3, 6, 6, 0, 3, 2, 6, 6, 1, 0, 3, 3, 3, 3, 3, 1, 3, 3, 1, 3, 3, 7, 3, 7, 1, 0, 7, 0, 3, 3, 6, 6, 3, 2, 2, 2, 5, 5, 5, 5, 7, 5, 5, 7, 7, 7, 7, 0, 3, 1, 7, 7, 7, 5, 4, 0, 0, 0, 4, 0, 1, 5, 5, 2, 4, 1, 1, 1, 0, 1, 3, 0, 1, 6, 3, 4, 1, 4, 4, 4, 4, 3, 3, 4, 5, 7, 3, 1, 2, 4, 4, 4, 2, 4, 4, 4, 4, 4, 1, 2, 4, 0, 6, 6, 7, 5, 3, 3, 3, 0, 5, 5, 5, 1, 2, 7, 6, 6
16, 16, 8, 16, 16, 16, 2, 2, 10, 10, 8, 6, 3, 2, 0, 0, 2, 6, 8, 2, 2, 2, 2, 2, 14, 5, 9, 5, 14, 5, 0, 7, 5, 0, 0, 0, 10, 1, 5, 10, 10, 1, 1, 1, 5, 7, 6, 10, 6, 6, 6, 10, 10, 14, 10, 1, 13, 5, 5, 13, 13, 11, 11, 3, 11, 11, 17, 3, 11, 11, 11, 11, 12, 3, 3, 9, 9, 3, 16, 17, 16, 9, 16, 3, 5, 3, 5, 5, 12, 3, 12, 12, 12, 12, 17, 3, 7, 7, 11, 1, 14, 14, 10, 14, 14, 10, 13, 14, 13, 13, 4, 13, 4, 1, 1, 1, 6, 6, 15, 7, 15, 16, 15, 17, 14, 14, 7, 8, 9, 9, 9, 17, 11, 3, 1, 15, 8, 14, 6, 9, 8, 6, 7, 6, 3, 3, 7, 10, 5, 5, 5, 7, 8, 7, 2, 7, 2, 8, 2, 2, 2, 0, 5, 8, 12, 12, 12, 4, 13, 13, 3, 16, 15, 14, 14, 14, 9, 5, 4, 11, 11
17, 3, 0, 3, 3, 7, 7, 7, 0, 0, 8, 8, 4, 7, 6, 5, 7, 8, 9, 7, 7, 7, 7, 7, 0, 10, 11, 5, 0, 5, 5, 3, 6, 2, 6, 5, 0, 10, 10, 0, 10, 10, 0, 10, 11, 8, 8, 0, 8, 8, 8, 0, 0, 0, 0, 0, 10, 6, 6, 10, 10, 2, 2, 4, 2, 2, 2, 4, 5, 2, 2, 11, 6, 4, 4, 9, 9, 4, 1, 9, 4, 9, 1, 4, 11, 4, 11, 5, 6, 11, 6, 6, 6, 1, 2, 4, 8, 5, 4, 10, 0, 10, 10, 10, 0, 10, 10, 0, 11, 10, 6, 4, 2, 10, 10, 10, 8, 8, 6, 3, 6, 3, 6, 1, 0, 0, 3, 10, 9, 9, 9, 9, 2, 4, 4, 10, 1, 9, 8, 9, 0, 8, 3, 8, 4, 4, 3, 10, 10, 4, 5, 5, 0, 3, 7, 3, 0, 0, 7, 7, 7, 5, 5, 9, 6, 1, 1, 10, 0, 11, 4, 9, 10, 0, 0, 0, 9, 4, 10, 11, 2
