0, 3, 0, 3, 3, 3, 3, 3, 13, 1, 13, 8, 8, 3, 6, 3, 9, 9, 15, 9, 9, 3, 3, 0, 1, 0, 8, 5, 0, 5, 14, 6, 2, 6, 14, 14, 3, 13, 2, 12, 13, 13, 12, 8, 8, 5, 5, 1, 9, 5, 5, 1, 13, 13, 1, 13, 4, 8, 8, 8, 8, 2, 2, 11, 2, 14, 14, 5, 14, 2, 2, 14, 2, 11, 8, 11, 11, 11, 4, 5, 5, 11, 11, 11, 5, 4, 8, 2, 14, 2, 11, 4, 9, 7, 7, 5, 5, 5, 7, 13, 4, 13, 13, 15, 13, 4, 13, 7, 8, 4, 10, 11, 2, 13, 4, 4, 12, 5, 10, 10, 10, 3, 15, 0, 1, 1, 6, 12, 13, 8, 7, 12, 7, 7, 15, 15, 15, 0, 9, 0, 0, 0, 3, 6, 5, 5, 9, 4, 4, 2, 14, 14, 3, 3, 0, 6, 9, 0, 9, 3, 0, 14, 2, 6, 14, 14, 10, 4, 13, 8, 2, 11, 12, 1, 1, 1, 7, 7, 10, 8, 2
1, 12, 2, 12, 12, 12, 12, 12, 17, 1, 0, 11, 15, 12, 6, 6, 8, 8, 8, 8, 8, 8, 8, 2, 11, 5, 11, 10, 2, 0, 10, 13, 10, 10, 10, 10, 0, 3, 3, 1, 1, 3, 1, 15, 3, 0, 0, 1, 9, 9, 9, 1, 1, 17, 1, 1, 17, 3, 6, 3, 3, 11, 6, 14, 6, 10, 2, 0, 14, 10, 18, 10, 4, 14, 18, 14, 18, 14, 17, 9, 9, 14, 14, 14, 0, 6, 3, 18, 4, 18, 14, 5, 4, 4, 4, 9, 9, 0, 18, 17, 17, 1, 1, 5, 5, 3, 5, 5, 3, 3, 4, 14, 6, 17, 17, 17, 9, 9, 16, 13, 7, 12, 4, 13, 11, 11, 7, 7, 13, 13, 18, 11, 10, 10, 16, 7, 9, 10, 8, 13, 2, 2, 6, 9, 9, 14, 9, 9, 18, 18, 10, 10, 2, 12, 12, 7, 8, 2, 8, 8, 12, 10, 6, 7, 15, 7, 16, 3, 17, 3, 6, 14, 4, 11, 11, 11, 10, 10, 4, 6, 6
2, 10, 7, 10, 10, 10, 10, 10, 6, 6, 6, 9, 6, 10, 10, 2, 0, 0, 13, 0, 0, 0, 0, 7, 12, 4, 6, 13, 7, 13, 10, 3, 2, 3, 10, 4, 14, 5, 2, 14, 6, 5, 14, 6, 6, 13, 13, 6, 0, 13, 13, 6, 6, 6, 6, 6, 5, 9, 12, 9, 9, 1, 2, 11, 2, 3, 3, 13, 1, 4, 1, 3, 2, 11, 4, 4, 4, 11, 5, 15, 15, 11, 11, 11, 2, 2, 2, 4, 4, 2, 11, 2, 11, 1, 14, 15, 15, 13, 1, 5, 5, 5, 12, 8, 5, 5, 12, 8, 9, 12, 12, 11, 2, 5, 5, 5, 15, 15, 8, 8, 8, 12, 8, 7, 12, 7, 3, 8, 7, 7, 1, 8, 1, 1, 1, 8, 8, 7, 0, 7, 7, 7, 13, 13, 15, 11, 13, 5, 4, 1, 4, 1, 4, 10, 0, 3, 0, 0, 0, 0, 15, 4, 2, 12, 3, 3, 9, 5, 12, 9, 2, 1, 8, 12, 6, 7, 1, 1, 14, 2, 2
3, 2, 15, 2, 2, 2, 2, 2, 5, 3, 4, 8, 5, 2, 10, 4, 15, 4, 9, 15, 15, 2, 2, 15, 13, 11, 0, 9, 9, 4, 10, 4, 11, 10, 10, 10, 13, 3, 11, 3, 3, 3, 3, 5, 11, 4, 4, 3, 4, 4, 4, 3, 3, 5, 3, 3, 5, 5, 11, 5, 11, 0, 11, 6, 11, 10, 7, 11, 6, 0, 0, 0, 1, 6, 0, 0, 0, 6, 3, 8, 8, 6, 8, 6, 11, 11, 11, 0, 7, 0, 6, 11, 14, 12, 1, 8, 3, 4, 6, 5, 5, 5, 5, 3, 5, 5, 5, 13, 5, 11, 1, 8, 7, 3, 5, 5, 3, 3, 1, 7, 1, 7, 12, 9, 13, 9, 7, 1, 9, 9, 0, 1, 12, 12, 12, 12, 1, 9, 8, 9, 9, 15, 4, 4, 14, 8, 4, 3, 11, 6, 10, 12, 2, 2, 15, 7, 15, 15, 15, 15, 15, 10, 10, 8, 7, 7, 11, 11, 5, 5, 11, 6, 1, 13, 13, 13, 12, 12, 12, 11, 11
4, 8, 11, 8, 8, 8, 8, 8, 2, 11, 12, 7, 7, 8, 1, 10, 11, 11, 8, 11, 11, 8, 8, 11, 4, 10, 7, 12, 7, 1, 4, 1, 10, 1, 4, 4, 11, 9, 10, 2, 2, 9, 12, 7, 12, 12, 12, 12, 11, 12, 12, 2, 2, 11, 11, 2, 9, 9, 7, 7, 7, 10, 10, 0, 10, 4, 5, 10, 6, 6, 6, 6, 10, 0, 7, 7, 7, 0, 9, 0, 0, 0, 0, 6, 10, 10, 10, 10, 4, 10, 0, 10, 3, 8, 8, 12, 12, 12, 10, 9, 9, 9, 9, 2, 9, 9, 9, 2, 7, 10, 3, 0, 10, 9, 9, 9, 7, 12, 3, 1, 8, 8, 2, 2, 4, 2, 1, 8, 7, 7, 6, 2, 6, 8, 8, 2, 7, 12, 11, 7, 7, 11, 1, 1, 12, 0, 1, 9, 10, 6, 6, 6, 8, 8, 8, 1, 11, 11, 11, 11, 11, 6, 10, 8, 5, 5, 3, 9, 9, 7, 10, 0, 3, 4, 4, 2, 6, 6, 3, 10, 10
5, 10, 17, 10, 10, 10, 10, 10, 9, 9, 3, 7, 7, 10, 16, 16, 10, 3, 10, 10, 10, 14, 14, 17, 6, 1, 7, 1, 1, 3, 16, 3, 16, 16, 16, 16, 15, 15, 15, 15, 15, 12, 15, 7, 7, 11, 3, 17, 3, 3, 3, 9, 15, 9, 7, 7, 9, 0, 0, 7, 7, 2, 2, 8, 2, 16, 18, 11, 11, 1, 11, 16, 13, 8, 5, 5, 5, 11, 0, 8, 8, 8, 8, 11, 11, 2, 7, 1, 13, 11, 13, 4, 13, 4, 5, 8, 0, 11, 11, 9, 9, 12, 12, 15, 15, 15, 5, 4, 7, 2, 6, 8, 2, 12, 0, 0, 0, 0, 14, 18, 18, 10, 12, 13, 4, 17, 18, 3, 1, 1, 1, 5, 5, 5, 14, 5, 4, 1, 10, 1, 1, 1, 3, 3, 8, 8, 3, 0, 0, 11, 1, 11, 10, 10, 10, 3, 10, 17, 10, 10, 3, 16, 16, 10, 18, 18, 13, 15, 9, 7, 2, 11, 12, 6, 4, 4, 5, 17, 6, 2, 2
6, 3, 14, 1, 3, 3, 3, 3, 9, 9, 18, 17, 17, 3, 11, 20, 14, 7, 3, 14, 14, 3, 3, 14, 12, 4, 17, 6, 17, 6, 6, 16, 4, 11, 2, 2, 1, 8, 11, 7, 8, 8, 7, 17, 17, 3, 6, 10, 14, 7, 20, 1, 1, 9, 14, 8, 9, 19, 1, 17, 17, 11, 11, 15, 11, 11, 7, 6, 5, 11, 4, 11, 2, 13, 4, 4, 4, 15, 10, 10, 10, 15, 15, 15, 20, 20, 17, 4, 2, 4, 2, 2, 18, 2, 15, 10, 10, 20, 5, 8, 9, 8, 9, 1, 8, 8, 1, 1, 17, 1, 0, 15, 11, 8, 8, 12, 10, 10, 0, 0, 0, 16, 7, 13, 12, 17, 16, 7, 13, 17, 13, 7, 13, 5, 5, 1, 0, 4, 10, 17, 6, 6, 20, 16, 10, 5, 16, 10, 4, 5, 13, 5, 1, 16, 3, 16, 14, 14, 14, 14, 16, 2, 11, 3, 5, 5, 2, 1, 12, 17, 20, 15, 7, 12, 12, 14, 13, 5, 0, 11, 11
7, 19, 21, 19, 19, 19, 19, 19, 3, 3, 3, 14, 7, 19, 4, 4, 6, 6, 14, 6, 6, 14, 14, 21, 1, 18, 7, 21, 21, 3, 4, 9, 4, 9, 4, 4, 3, 18, 22, 8, 8, 8, 8, 17, 2, 12, 12, 8, 19, 12, 12, 8, 8, 3, 8, 8, 3, 8, 14, 17, 17, 16, 16, 15, 16, 16, 23, 0, 20, 7, 7, 7, 5, 15, 7, 7, 7, 15, 17, 12, 12, 15, 15, 15, 2, 2, 2, 7, 5, 13, 15, 2, 23, 1, 7, 12, 12, 12, 20, 17, 17, 8, 8, 18, 18, 8, 17, 18, 17, 2, 22, 15, 16, 17, 17, 17, 12, 12, 10, 9, 22, 19, 5, 11, 1, 11, 9, 9, 11, 11, 0, 5, 0, 0, 13, 5, 14, 21, 14, 11, 21, 21, 4, 9, 12, 15, 13, 17, 0, 0, 0, 0, 13, 19, 19, 9, 6, 6, 6, 6, 18, 4, 4, 19, 20, 20, 10, 14, 19, 7, 2, 15, 5, 1, 1, 1, 0, 20, 22, 2, 16
8, 8, 8, 11, 8, 8, 8, 8, 11, 11, 1, 6, 6, 8, 10, 7, 8, 1, 12, 8, 8, 8, 8, 8, 11, 4, 4, 11, 4, 12, 2, 10, 7, 10, 2, 2, 12, 3, 7, 12, 3, 3, 12, 6, 6, 12, 1, 1, 1, 1, 1, 3, 3, 11, 8, 3, 11, 3, 6, 6, 6, 2, 7, 5, 7, 2, 9, 11, 5, 2, 2, 2, 0, 5, 4, 4, 4, 5, 3, 5, 1, 5, 5, 5, 7, 6, 6, 4, 2, 7, 5, 0, 0, 12, 0, 1, 1, 1, 7, 11, 3, 3, 11, 9, 3, 3, 3, 3, 6, 6, 0, 5, 6, 3, 3, 3, 3, 1, 0, 10, 9, 10, 9, 4, 3, 4, 10, 10, 4, 4, 4, 12, 9, 4, 9, 9, 8, 4, 8, 4, 4, 11, 10, 1, 5, 5, 1, 3, 0, 7, 2, 2, 12, 10, 8, 10, 8, 8, 8, 8, 8, 2, 7, 8, 10, 2, 0, 3, 3, 6, 7, 5, 12, 3, 3, 3, 9, 7, 9, 6, 7
9, 7, 12, 5, 7, 7, 7, 7, 13, 13, 7, 15, 5, 12, 1, 2, 12, 12, 7, 12, 7, 7, 7, 12, 13, 5, 15, 5, 11, 16, 14, 4, 1, 4, 14, 14, 16, 16, 2, 16, 9, 9, 16, 15, 2, 16, 0, 12, 12, 0, 0, 12, 9, 13, 12, 9, 13, 9, 15, 15, 15, 1, 1, 11, 1, 1, 3, 5, 0, 3, 3, 14, 14, 11, 5, 3, 3, 8, 9, 0, 7, 11, 11, 8, 15, 15, 15, 5, 14, 5, 8, 1, 10, 8, 8, 0, 0, 0, 8, 13, 13, 9, 13, 1, 9, 9, 9, 1, 15, 15, 10, 8, 1, 9, 9, 9, 0, 0, 2, 4, 2, 4, 6, 15, 13, 11, 4, 4, 11, 5, 5, 6, 8, 7, 6, 2, 2, 5, 7, 5, 5, 16, 4, 4, 0, 11, 4, 9, 5, 8, 14, 14, 12, 4, 7, 4, 12, 12, 12, 12, 4, 14, 1, 7, 11, 1, 10, 9, 13, 5, 5, 8, 6, 13, 13, 8, 8, 8, 10, 15, 1
10, 6, 8, 6, 6, 6, 6, 6, 6, 2, 6, 8, 7, 6, 4, 7, 1, 1, 6, 1, 1, 6, 1, 1, 3, 0, 8, 0, 6, 7, 0, 4, 0, 4, 4, 0, 6, 2, 7, 6, 2, 2, 6, 6, 7, 7, 7, 1, 1, 1, 7, 8, 8, 2, 8, 2, 2, 2, 7, 7, 7, 7, 7, 5, 7, 4, 4, 0, 5, 0, 0, 0, 3, 5, 8, 8, 8, 5, 2, 5, 6, 5, 5, 5, 7, 7, 7, 0, 3, 0, 5, 7, 3, 3, 3, 5, 1, 7, 7, 2, 2, 2, 2, 6, 2, 2, 2, 6, 7, 7, 3, 5, 7, 2, 2, 2, 1, 1, 3, 4, 4, 6, 3, 2, 8, 8, 4, 4, 8, 8, 0, 6, 0, 3, 3, 6, 6, 0, 1, 8, 0, 0, 7, 1, 5, 5, 1, 2, 0, 0, 0, 0, 6, 6, 1, 4, 6, 1, 1, 1, 8, 0, 7, 6, 4, 4, 3, 2, 2, 8, 7, 5, 7, 8, 8, 8, 0, 5, 3, 7, 7
11, 1, 6, 6, 1, 1, 1, 1, 13, 13, 6, 12, 12, 6, 0, 0, 6, 6, 1, 6, 1, 1, 1, 6, 11, 5, 12, 5, 15, 0, 9, 10, 9, 17, 9, 9, 13, 8, 5, 13, 8, 8, 6, 12, 12, 12, 2, 6, 6, 6, 2, 13, 13, 13, 6, 8, 13, 8, 12, 12, 12, 17, 16, 14, 17, 7, 7, 0, 2, 16, 16, 9, 16, 14, 5, 14, 14, 14, 4, 2, 1, 14, 14, 14, 0, 0, 12, 15, 9, 5, 14, 0, 7, 3, 11, 2, 2, 2, 16, 4, 13, 8, 13, 4, 8, 8, 4, 4, 12, 4, 4, 14, 17, 8, 4, 13, 5, 2, 3, 10, 3, 10, 3, 15, 11, 15, 10, 10, 15, 15, 16, 15, 16, 3, 3, 3, 1, 5, 1, 15, 5, 5, 10, 5, 2, 2, 2, 5, 5, 16, 9, 9, 6, 10, 1, 10, 1, 6, 1, 6, 10, 9, 9, 1, 7, 7, 3, 5, 11, 12, 0, 14, 3, 11, 11, 11, 16, 9, 3, 0, 17
12, 14, 9, 18, 14, 14, 14, 14, 1, 1, 2, 10, 10, 14, 6, 6, 9, 9, 14, 9, 9, 14, 14, 9, 8, 0, 10, 0, 0, 11, 11, 3, 6, 3, 11, 11, 14, 5, 6, 5, 5, 5, 5, 10, 2, 2, 2, 15, 2, 2, 2, 15, 15, 1, 18, 5, 1, 5, 2, 10, 2, 6, 6, 4, 6, 17, 13, 0, 12, 12, 12, 12, 15, 4, 10, 10, 10, 12, 7, 7, 2, 4, 4, 4, 12, 6, 6, 10, 15, 12, 12, 6, 13, 16, 8, 15, 2, 2, 12, 1, 1, 5, 1, 18, 5, 5, 7, 18, 10, 10, 17, 4, 6, 5, 5, 7, 7, 7, 15, 3, 15, 14, 15, 13, 8, 10, 3, 8, 13, 10, 12, 8, 11, 1, 8, 14, 14, 7, 9, 0, 0, 0, 6, 2, 7, 4, 2, 7, 7, 12, 11, 12, 14, 14, 0, 3, 9, 9, 9, 9, 0, 11, 6, 0, 3, 3, 13, 7, 1, 10, 6, 4, 8, 8, 0, 18, 11, 11, 7, 6, 6
13, 0, 6, 5, 0, 5, 5, 5, 1, 1, 2, 8, 8, 5, 12, 12, 5, 5, 6, 5, 5, 6, 6, 6, 9, 3, 3, 6, 8, 6, 7, 10, 12, 7, 7, 7, 6, 11, 9, 0, 11, 11, 0, 1, 8, 6, 2, 0, 5, 5, 2, 6, 6, 1, 6, 11, 1, 11, 12, 8, 8, 12, 12, 13, 12, 7, 7, 2, 4, 7, 3, 7, 12, 13, 3, 3, 3, 13, 11, 3, 2, 13, 13, 13, 12, 8, 8, 3, 7, 13, 13, 9, 9, 4, 13, 2, 2, 2, 3, 1, 1, 11, 1, 5, 5, 11, 1, 5, 11, 12, 0, 13, 12, 11, 11, 1, 10, 11, 9, 9, 9, 5, 0, 8, 0, 8, 10, 10, 8, 8, 3, 8, 0, 3, 0, 0, 10, 6, 5, 8, 6, 6, 5, 3, 2, 2, 5, 11, 3, 3, 7, 4, 5, 5, 5, 10, 6, 6, 5, 6, 5, 7, 12, 10, 4, 4, 4, 11, 1, 8, 12, 3, 0, 10, 0, 0, 0, 4, 9, 12, 9
14, 2, 10, 2, 2, 2, 20, 2, 11, 11, 5, 8, 15, 2, 16, 21, 10, 14, 20, 10, 10, 20, 20, 10, 22, 15, 15, 0, 15, 0, 0, 16, 21, 9, 21, 21, 20, 3, 3, 0, 18, 18, 0, 8, 8, 20, 14, 5, 5, 14, 14, 5, 5, 11, 5, 22, 11, 18, 14, 8, 8, 17, 17, 7, 17, 9, 6, 7, 7, 9, 17, 21, 1, 0, 6, 6, 6, 7, 3, 14, 14, 7, 7, 7, 7, 8, 8, 17, 9, 7, 7, 17, 6, 13, 13, 14, 5, 5, 7, 11, 11, 18, 11, 12, 12, 3, 11, 12, 8, 8, 13, 9, 17, 22, 3, 11, 5, 5, 20, 16, 1, 2, 1, 15, 22, 15, 16, 19, 19, 15, 6, 1, 4, 4, 4, 15, 14, 14, 14, 15, 0, 0, 16, 14, 14, 14, 14, 3, 3, 7, 0, 7, 2, 2, 2, 16, 10, 10, 10, 10, 2, 21, 21, 2, 4, 4, 13, 3, 11, 8, 17, 7, 1, 22, 22, 22, 19, 4, 1, 17, 17
15, 5, 9, 5, 5, 5, 5, 5, 5, 5, 8, 10, 9, 5, 6, 6, 5, 5, 5, 5, 5, 5, 5, 9, 2, 9, 9, 9, 9, 8, 7, 8, 6, 7, 7, 7, 5, 1, 6, 5, 1, 1, 5, 10, 0, 5, 8, 5, 5, 5, 8, 5, 1, 5, 5, 1, 1, 1, 10, 10, 6, 6, 6, 0, 6, 7, 10, 8, 7, 7, 3, 7, 7, 0, 3, 10, 3, 7, 1, 0, 0, 0, 0, 3, 6, 6, 8, 3, 7, 3, 3, 6, 4, 2, 2, 0, 0, 8, 6, 1, 1, 1, 1, 4, 1, 1, 3, 5, 6, 3, 2, 0, 6, 1, 1, 1, 0, 0, 4, 2, 2, 10, 4, 10, 2, 10, 8, 8, 2, 9, 3, 3, 7, 2, 3, 4, 4, 9, 5, 9, 9, 9, 8, 8, 0, 0, 8, 1, 3, 3, 7, 7, 5, 4, 5, 8, 5, 5, 5, 5, 9, 7, 6, 4, 10, 10, 2, 4, 1, 10, 6, 3, 9, 5, 1, 2, 7, 7, 2, 6, 6
16, 8, 14, 6, 8, 8, 8, 8, 5, 5, 12, 12, 12, 8, 9, 9, 14, 14, 8, 8, 8, 8, 8, 14, 6, 2, 12, 0, 7, 0, 11, 0, 9, 11, 11, 11, 4, 10, 2, 10, 10, 10, 14, 12, 12, 0, 0, 14, 14, 0, 0, 14, 14, 5, 14, 10, 5, 10, 12, 12, 12, 11, 9, 3, 9, 11, 11, 0, 3, 11, 4, 11, 9, 3, 4, 4, 4, 3, 16, 14, 14, 3, 3, 3, 3, 9, 12, 4, 11, 4, 3, 9, 6, 13, 13, 14, 16, 0, 3, 5, 5, 10, 5, 15, 15, 10, 5, 15, 12, 12, 1, 3, 4, 10, 10, 5, 14, 14, 13, 15, 17, 8, 17, 7, 6, 7, 16, 16, 11, 7, 7, 16, 11, 13, 13, 17, 17, 2, 14, 7, 7, 0, 0, 0, 0, 3, 0, 2, 2, 2, 11, 11, 8, 15, 8, 16, 8, 14, 8, 8, 16, 11, 9, 8, 15, 15, 1, 2, 5, 12, 9, 3, 17, 6, 6, 6, 11, 7, 1, 9, 9
17, 9, 8, 9, 9, 9, 15, 9, 1, 1, 15, 3, 3, 9, 18, 10, 8, 15, 13, 15, 15, 15, 15, 8, 5, 3, 3, 13, 13, 13, 2, 4, 12, 2, 2, 2, 14, 14, 12, 14, 14, 14, 8, 10, 10, 0, 0, 8, 15, 0, 0, 17, 8, 1, 8, 14, 1, 14, 12, 10, 10, 12, 12, 18, 12, 2, 11, 0, 18, 2, 6, 2, 12, 2, 3, 3, 6, 6, 0, 0, 0, 18, 18, 6, 10, 10, 10, 12, 2, 6, 6, 17, 17, 6, 6, 0, 0, 0, 6, 1, 1, 14, 14, 5, 14, 14, 14, 17, 10, 10, 7, 5, 7, 14, 11, 1, 0, 0, 16, 5, 16, 9, 16, 17, 7, 3, 4, 4, 11, 3, 6, 16, 6, 13, 16, 16, 16, 0, 0, 3, 13, 13, 4, 4, 0, 18, 4, 0, 0, 6, 6, 6, 9, 9, 9, 4, 8, 8, 15, 8, 4, 2, 10, 15, 11, 11, 17, 14, 5, 3, 10, 18, 16, 5, 5, 17, 6, 6, 7, 10, 12
